%%%%%%%%%%%
%G . . P%%%
%G  G GG%%%
%%%%%%%%%%%
% % % % % %
%%%%%%%%%%%
