%%%%%%%%%%%%%%%%%%%%%%%%%%%%%%%%%%%%%%%%%%
%                                        %
%                                        %
%              %               %         %
%                %       %%    %         %
%                                  %     %
%         %                        %     %
%            %%%%%%%  %%%%%%%%           %
%           %%               %%          %
%          %%     %%%%%%%     %%      %  %
%              %%%%     %%%%             %
%        %%  %%%           %%%  %%    %  %
%       %%  %%               %%  %%      %
%      %%  %%                 %%  %%     %
%      %            GG             %     %
%      %%  %%       GG        %%  %%     %
%  %    %%  %%               %%  %%      %
%        %%  %%%           %%%  %%       %
%    %         %%%       %%%             %
%          %%    %%%%%%%%%    %%      %  %
%    %      %%       P       %%          %
%            %%%%%%%  %%%%%%%%     %     %
%   %                                    %
%                 %          %           %
%       %                 %         %    %
%                                        %
%%%%%%%%%%%%%%%%%%%%%%%%%%%%%%%%%%%%%%%%%%
% % % % %                                %
%%%%%%%%%%%%%%%%%%%%%%%%%%%%%%%%%%%%%%%%%%
